#         B
# ######### 
# #      ## 
# # #### ## 
#   #    ## 
### # ##### 
A   #       